---------
|       |
|!|     |
|--  |! |
| @  |--|
|    |!!|
|       |
|    -|!|
---------