---------
|       |
| |     |
|--  |  |
| @  |--|
|    |  |
|       |
|    -| |
---------