--------
|      |
| @ |--|
|   |  |
|      |
|   -| |
--------