******
*    *
*    *
*@   *
******